111111111111111111111111111111111111111111111111111111111111
1S1000000000100010000010000000100000000010000000000010000000
101011111010101011101011100010101111111010101111111011101011
101010000010001000001010001010001010000010101000001000101000
101110111111111111111010101011111010111111101011101110111110
100000100000000010000010100010000010000010001000100010000000
111111101111101110111110111110111111111010111110111011111110
101000001010001000100010000010000000100010000010001000001000
101011101010111011101110111011111110101110111011111011101011
101000101010001000100000001000000010001000001000001010101010
101110101011101110101111111110111010111111101111101010101010
101000101000000010101000000010001010100000100000101010101010
101011101111101110101011111011111010101110111111101010101010
100000100000101000101010001000000010101000000000001000101010
101111111010111011101010111111111110101111111111111011101010
000010001010100010001010000000100000100010000000001010001010
111010101010101110111010101110101111101010111110111010111010
100010101010100010001010101000101000101010000010000010001010
111110101010111011111010101011101010101011111011111111101010
100000101000001000001010101010001010101000001000100000101000
101111101011101111101011101010111011101111101110111011101110
101000101010101000001010001010101000101000101000001000100010
101010101010101011111010101110101010101110101011101110101010
101010101000101000000010101000100010000000001000001000101010
101011101111101111111110111011101111111111100011101010101110
101010001000000000000000100010001000101000101000101010100000
101010101011111111111110101111101010101010101010101010111111
101000000010000000100000101000100010001010100010100010000010
101011111110111110101011101010111111111010111000111111111010
101010001000100010001010100010000000100010000000100000100010
101110101110101011101010111111111110101111111101101110101110
100000100010001000101000100000001000100000100000000010101000
101111111011111110111110111011111011111110101010111011101110
100000101010000010000000000010001010000010101010001000100000
111110101010111010111111101110101010111010101011111110111100
100000101000100000001000101000100010100010001010000000000000
101111101111101111111010111000111110101111111010111111111110
101000101000001000000010000010000000100010000010000000100000
1010101010111110111111111111111011111110101111101111101011E1
100010001000000000000000000000001000000000100000000010000000